00000000000000000000000000000000000000000000000000000000000000000000000000000000000000000000000000000000000000000000000000000000
00000000000000000000000000000000000000000000000000000000000000000000000000000000000000000000000000000000000000000000033333333333
00000000000000000000000000000000000000000000000000000000000000000000000000000000000000000000000000000000000000000222233333333333
00000000000000000000000000000000000000000000000000000000000000000000000000000000000000000000000000000000000000000000033333333333
00000000000000000000000000000000000000000000000000000000000000000000000000000000000000000000000000000330000000000000033333333333
00000000000000033333333333333333333333330000000002222222000000000000000000000000000000000000000000033330000000000000033333333333
33333333333333333333333333333333333333333300000000000000000000333333333333333300000000000000000003333330000000000000033333333333
33333333333333333333333333333333333333333333333300000000003333333333333333333333300000000000000333333330000000000000033333333333
33333333333333333333333333333333333333333333333311111111133333333333333333333333333333333333333333333333333333333333333333333333
